RRRRRRRRRRRRRRRRRRRRRRRRRRRRRR
RRRRRRRRRRRRRRRRRRRRRRRRRRRRRR
PAAAAAAAAAAAAAAAAAAAAAAAAAAAAA
AAAAAAAAAAAAAAAAAAAAAAAAAAAAAA
AAAAAAAAAAAAAAAAAAPAAAAAAAAAAA
AAAAAAAAAAAAAAAAAAAAAAAAAAAAAA
AAAAAAAAAAAAAAAAAAAAAAPAAAAAAA
AAAAAAAAAAAAAAAAAAAAAAAAAAAAAA
AAAAAAAAAAAAAAAAAAAAAAAAAAAAAA
AAAAAAAAAAAARRRRRRAAAAAAAAAAAA
AAAAAAAAAAAARRRRRRAAAAAAAAAAAA
AAAAAAAAAAAARRRRRRAAAAAAAAAAAA
AAAAAAAAAAAARRRRRRAAAAAAAAAAAA
AAAAAAAAAAAARRRRRRAAAAAAAAAAAA
AAAAAAAAAAAAAAAAAAAAAAPAAAAAAA
AAAAAAAAAAAAAAAAAAAAAAAAAAAAAA
AAAAPAAAAAAAAAAAAAAAAAAAAAAAAA
AAAAAAAAAAAAAAAAAAAAAAAAAAAAAA
APAAAAAAAAAAAAAAAAAAAAAAAPAAAA
AAAAAAAAAAAAAAAAAAAAAAAAAAAAAA
AAAAAAAAAAAAAAAAAAAAAAAAAAAAAA
AAAAAAAAAAAAAAAAAAAAAAAAAAAAAA